::::::::::
Row Format:
SE | PI L1 < PI L2 > PI L3 ¦ PI full mode

For more information, read the corpus_info.md file.
::::::::::

academia | ăcad(e̖/ĕ̖)mia < ăca̬d(e̖/ĕ̖)mia̬ >  … (CP/LCP)
academic | ăcadĕ̖mic < ăca̬dĕ̖mic >
accent_n | acce̗nt
accent_vb | (acce̗nt/a̗cce̖nt)
accompany | accômpany < a̬ccômpa̬ny >
accurate | accurȧte < accu̱rȧte > **
across | acro̖ss < a̬cro̖ss >
ache | āc̣he
adhere | a̗dhe̖re
alarm | ala̖rm < a̬la̖rm >
almond | (äl̊/ăl)mond < (äl̊/ăl)mo̬nd >  … (CP/SP)
amateur | ăma(te͜ur/te͡ur/‹chər›/‹chuər›) < ăma(te͜ur/te͡r/‹chə͜r›/‹chuə͜r›) > … [Sf½]{ama‹teur›}
amoeba | amo̊ēba < a̬mo̊ēba̬ > a̬mo̊e̖ba̬
another | anôther < a̬nôthe͜r >
Antarctica | Ant꞉ar(c/c̊)tica < Ant꞉ar(c/c̊)tica̬
anywhere | ‹ĕny›·whĕre … [Sf]{‹any›where}
apostrophe | apo̖strophē < a̬po̖stro̬phē >
applicable | appl(i/ĭ)able < (applica̬b͜le/a̬pplĭca̬b͜le) >
Arab | Ara̬b
Arabian | Ara̖bian < A̬rabia̬n > ** ¦ A̬ra̖bia̬n
Arabic | Arabic < Ara̬bic >
archipelago | arc̣hipĕlago < arc̣hipĕla̬go >
aspect | aspe̗ct ¦ a̖spe̗ct
asthma | as(t̊h̊/th)ma < as(t̊h̊/th)ma̬ >
baroque | (bărŏ̖que/ba̬ro̖que) < (bărŏ̖que/ba̬ro̖que) > (bărŏ̖que/ba̬ro̖que) ¦ (bărŏ̖qůe̊/ba̬ro̖qůe̊) … (GB/GA)
beloved_1 | belôvėd< bėlôvėd >
beloved_2 | belôve̊d < bėlôve̊d > belôved
biological | bi̱olŏgical < bio̬lŏgica̬l > biolŏgical ¦ bi̱o̬lŏgica̬l
biological | bi̱olŏgic < bio̬lŏgic > biolŏgic ¦ bi̱o̬lŏgic
biology | bi̱ŏlogy < bi̱ŏlo̬gy > biŏlogy ¦ bi̱ŏlo̬gy
bough | b‹ow› … [Sf]{b‹ough›}
breath | brĕath
breathe | breathe
bull | büll
busy | b‹izzy› < bu̇sy > bu̇sy … [Sf1]{b‹usy›}
business | b‹iz›ness < bu̇si̊nėss > bu̇si̊ness … [Sf1]{b‹usi›ness}
Caesar | Cåesar < Cåesa͜r >
canine | cani̱ne
cannabis | cannabiṣ < canna̬biṣ >
carnival | ** < carni̬val >
castle | cast̊le < cast̊͜le >
category | cătegory < cătė̬g(o̬/o̗)ry > … (GB/GA)
cater | ** < cate͜r >
chough | ch‹uff› … [Sf]{ch‹ough›}
cliché | clïché
climb | clīmb̊ < * > clīmb
compass | cômpa̬ss
complex | cŏmpl(e̗/e̖)x
 < (cŏmple̗x/co̬mple̖x) > … (GB/GA)
composite | comp(ŏ/o)si̯te < (co̬mpŏsi̯te/compo̬si̯te) > … (GA/GB)
company | cômpany < cômpa̬ny >
component | compōnent < c(o̬/o̗)mpōne̬nt > *
content_1 | cŏnte̗nt
content_2 | conte̖nt < co̬nte̖nt >
corpus | corpuṣ < corpu̬ṣ >
corpora | corpora < corpo̬ra̬ >
country | co͡untry
cough | c(‹aw›/o)ff … (GA/GB) … [Sf]{c‹ough›}
cover | côver < côve͜r >
create | crea̖te < crea̖te > crea̖te ¦ crea̖te
creation | crea̖tion < crea̖tio̬n > crea̖tion ¦ crea̖tio̬n
Danish | Dānish
deity | d(ē/‹ay›)¹(i/i̬)²ty … ¹(CP/LCP) ²(GB/GA) … [Sf½]{d‹ei›ty}
desert_1 | dĕsert < dĕse͜rt >
desert_2&3 | dese̖rt < dėse͡rt >
dessert | des͝se͡rt < dės͝se̖rt > des͝se̖rt ¦ dės͝se͡rt
detail | det(a̖i/a̗i)l < (dėta̖il/deta̗il) >
detailed | det(a̖i/a̗i)le̊d < (dėta̖ile̊d/dēta̗ile̊d) > det(a̖i/a̗i)led
diacritic | di̱acrĭtic < dia̬crĭtic > diacrĭtic ¦ di̱a̬crĭtic
diaeresis | di̱(‹a̖›/‹e̖›)reṣiṣ < di(‹a̖›/‹e̖›)rė̬ṣiṣ > di(‹a̖›/‹e̖›)reṣiṣ ¦ di̱(‹a̖›/‹e̖›)rė̬ṣiṣ
direct | dire̖ct ¦ d(ī/i/i̬)re̖ct
done | dône
don't | dōn't
dull | dŭll
ease | ease
easy | easy
educate | ĕducate ¦ ĕduca̗te
education | ĕduca̖tion < ĕducatio̬n > ĕducation ¦ ĕduca̖tio̬n
efficacy | ** < effica̬cy >
efficacious | e̗ffica̖cio͜uṣ < e̗ffica̖cio͜uṣ > e̗ffica̖ciouṣ
endeavour | endĕavo͜ur < ėndĕavo͜ur > endĕavour
England | ‹I›ngland < Ėngland > Ėngland … [Sf1]{‹E›ngland}
English | ‹I›nglish < Ėnglish > Ėnglish … [Sf1]{‹E›nglish}
echo | ec̣ho
everybody | ĕve̊ry·b(ŏ/ô)dy
everyday | ĕve̊ry·day
everyone | ĕve̊ry·‹wun› … [S½]{every‹one›}
everything | ĕve̊ry·t̤hing < ĕve̊ry·t̤hin͠g >
exaggerate | exa̖g͝gerate < ėxa̖g͝ge̬rate > ** ¦ ėxa̖g͝ge̬ra̗te
flood | flo͡od
focus | focuṣ < focu̬ṣ >
foe | foe̊ < ** > **
formidable | (formĭdable/formidable) < (fo̬rmĭda̬b͜le/formida̬b͜le) > … (GB/GA)
friend | fri̊end
fiend | fı͞end < * > **
fundamental | fundame̖ntal < funda̬me̖nta̬l > * ¦ fu̗nda̬me̖nta̬l
Ganesha | Ganësha < Ga̬nësha̬ >
gasoline | găṣol(ï/ï̖)ne < găṣo̬l(ï/ï̖)ne > … (GA/GB)
ghost | ghōst … [FE]
geographical | ge̱ogra̖phical < geo̬gra̖phica̬l > geogra̖phical ¦ ge̱o̬gra̖phica̬l
geographic | ge̱ogra̖phic < geo̬gra̖phic > geogra̖phic ¦ ge̱o̬gra̖phic
geography | ge̱ŏgraphy < geŏgra̬phy > geŏgraphy ¦ ge̱ŏgra̬phy
ginger | ** < ginge͜r >
gone | gŏne
honest | h̊ŏnest < h̊ŏnė̬st >
honor | h̊ŏnor < h̊ŏno͜r >
hierarch | hīera̗rc̣h < hī(e̬/e̊)ra̗rc̣h >
hierarchical | hīera̖rc̣hical < hī(e̬/e̊)ra̖rc̣hica̬l
hierarchy | hīera̗rc̣hy < hī(e̬/e̊)ra̗rc̣hy > * ¦ hī(e̬/e̊)ra̗rc̣hy
hygiene | (hygi͟ene/hȳgiene) < (hygi͟ene/hygı͞ene) > (hygi͟ene/hygı͞ene) ¦ (hygi͟ene/hȳgiene)
identify | ide̖ntifȳ < (ī/i)de̖nti̬fȳ >
imam | imäm
infinity | infĭnity
infinite | infini̯te < infi̬ni̯te >
iron | ‹īə͜rn› … [Sf]{‹iron›}
isn't | is͜n't < * > **
itself | it꞉self
journal | jo͡urnal < jo͡urna̬l >
journey | jo͡urney < jo͡urne̱y >
finite | finite < * > * ¦ fini̗te
language | language < languȧge >
laugh | l‹af› … [Sf]{l‹augh›}
leopard | lĕo̊pard < lĕo̊pa͜rd >
Lesotho | Leṣö̖th̊ö < Lė̬ṣö̖th̊ö >
lettuce | lettu̇ce
loan | loan
lone | lōne
loose | lo͞oṣe
lose | löse
machine | mac̤hïne < ma̬c̤hïne >
many | m‹ĕny› … [Sf]{m‹any›}
martyr | ** < marty͜r >
mature | matu̖re < ma̬tu̖re >
meadow | mĕadow
medicine | mĕdici̯ne < mĕdi̬ci̯ne >
mentor | ** < ment(o̗/o̬)r > ment(o̗/o̬)r
Messiah | Messīah < Mėssīa̬h >
Michael | Mīc̣ha͜el < * > Mīc̣hael
muscle | musc̊le < musc̊͜le >
muscular | muscular < muscu̱la͜r > **
Mycenae | Myce̖nåē < * > * ¦ Mȳce̖nåē
Mycenaean | Mycenåēa̬n < Mycėnåēa̬n > Mycenåēa̬n ¦ Mȳcėnåē̖a̬n
naive | na̬ïve
naked | nakėd
nature | ** < natu̱re >
nineteenth | nine̥teenth < * > ** ¦ nine·teenth·
none | nône
nonetheless | nône·the̬꞉less
nourish | no͡urish
nuance | n(ū/ü)¹(ä/ä̖)²nce … ¹(GB/GA) ²(CP/LCP)
oven | ôven < ôve̬n >
over | ** < ove͜r >
peninsula | peni̖nsula < pe̬ni̖ns(u̱/u̬)la̬ > … (GB/GA)
pineapple | pine·apple < pine·app͜le >
plugin | plug·in
possess | pos͝se̖ss < po̬s͝se̖ss >
possession | pos͝se̖ssion < po̬s͝se̖ssio̬n >
prayer_1 | pr‹air› … [Sf]{pr‹ayer›}
prayer_2 | ** < praye͜r >
primary | primary < prim(a̬/a̗)ry > … (GB/GA)
primarily | prim(a̖/a)rily < (prima̖ri̬ly/prima̗ri̬ly/prima̬ri̬ly) >
progress_n | (progre̗ss/prŏgress) < (progre̗ss/prŏgr(e̗/e̬)ss) > … (GB/GA)
project | prŏject < prŏj(e̗/ė)ct >
promise | prŏmiṣe
protein | prot(ein/ei̗n) < prot(e̱in/e̱i̗n) >
pronounce | ** < pro̬nounce >
pronunciation | pronu̗ncia̖tion < pro̬nu̗ncia̖tio̬n >
purpose | pu͡rpo̬ṣe < purpo̬ṣe > purpo̬ṣe
pursuit | pursui̊t < pu͜rsui̊t >
ragged | raggėd
real | (reˌal/r‹eel›) < (reˌa̬l/r‹eel›) > … Sf½{r‹eal›}
realism | reˌali̗s͜m < reˌa̬li̗s͜m > reˌalis͜m
realistic | reˌali̖stic
reality | reˌălity
receipt | recēip̊t < rėcēip̊t >
release | releaṣe < rė̬leaṣe >
rendezvous | ‹r_en_d(e̬/ë)voo› … [Sf]{‹rendezvous›}
research | r(ė/ē)ṣe͡arch < * > … (GB/GA)
rigor | rĭgor < rĭgo͜r >
routine | röutï̖ne
saga | säga < säga̬ >
said | sa̤id
says | sa̤ys
scarce | sc‹air›rce < scārce > scārce … [Sf1]{sc‹ar›ce}
scarcity | sc‹air›city < scārcity > scārcity … [Sf1]{sc‹ar›city}
scarcity | scārcity < 
schedule | (sch/sc̣h)ĕdule … (GB/GA)
scissors | scis͝sors < scis͝so͜rs > … [FE]
scone | sc(ōne/ŏne)
Shiah | Shïah < Shïa̬h >
shoe | shöe̊ < shöe > shöe
simplify | si̖mplifȳ < si̖mpl(i/i̬)fȳ >
smooth | smo͞oṭh
Southampton | South꞉(/‹h›)ampton < South꞉(/‹h›)ampto̬n > … (CP/LCP) … [Sf½]{South‹›ampton}
species_sing | (specie̱s/speci͟es/speciėṣ) < * > ** (CP/LCP/AP)
species_pl | (specie̱s/speci͟es/specie̱s) < * > ** (CP/LCP/AP)
subtle | ‹suttle› < sub̊t͜le > sub̊tle … [Sf1]{‹subtle›}
subtlety | ‹suttle›ty < sub̊t͜leˌty > sub̊tleˌty … [Sf1]{‹subtle›ty}
sugar | s̩ügar < s̩üga͜r >
Sunni | Sünni
surface | su͡rface < surf(ȧ/a̬)ce > ** ¦ su͡rf(ȧ/a̬)ce … (GB/GA)
thorough | t̤hôr(ōugh/o͜ugh)
though | thōugh
thyme | (th̊/th)yme … (CP/SP)
through | t̤hröugh
today | to̬day
tomb | tömb̊ < * > tömb
tourism | töuris͜m ¦ töuri̗s͜m
true | true̊ < ** > **
truth | trūth
undergo | under꞉go < unde͜r꞉go >
underwent | under꞉went < unde͜r꞉went >
understand | under꞉stand < unde͜r꞉stand >
understood | under꞉sto͝od < unde͜r꞉sto͝od >
unique | u̱nïque < * > unïque ¦ u̱nïqůe̊
upend | up꞉end
vague | vagůe̊ < ** > ** ¦ vagůe̊
vaguely | vagůe̊ly
variant | ** < varia̬nt >
variation | varia̖tion < varia̖tio̬n >
variety | varīˌety < va̬rīė̬ty >
various | vario͜uṣ < * > variouṣ
vernacular | vernăcular < ve͜rnăcu̱la͜r >
volley | ** < volle̱y >
volleyball | ** < volle̱y·baᷱll >
were | we͡re
whilst | whīlst
without | 
woman | w‹o͝o›man < w‹o͝o›ma̬n > … [Sf]{w‹o›man}
women | w‹ĭmin› < wȯmėn > ** … [Sf1]{w‹omen›}
won | wôn

January | Jănuary ¦ Jănua̗ry
February | Fĕb(r/r̊)uary ¦ Fĕb(r/r̊)ua̗ry
March | 
April | ** < Aprîl >
May | 
June | 
July | Julȳ < Ju̬lȳ >
August | Augu̗st
September | Se̗pte̖mber < Se̗pte̖mbe͜r >
October | O̗cto̖ber < O̗cto̖be͜r >
November | Nove̖mber < N(o/o̬)ve̖mbe͜r >
December | Dece̖mber < Dėce̖mbe͜r >